*********
*   *   *
*** * * *
*   * * *
* ***** *
*       *
*********
