* **********
*          *
*          *
*          *
***** ******
*      *   *
*  *   *   *
*  *       *
*  *   *   *
** *****   *
*      *   *
********** *
