*************************************************************
*     *               *       *             *   *           *
***** * *************** * ***** * ********* * * ********* * *
* *   * *   *   *   *   *   *   * *       *   *         * * *
* * *** * * * * * * * ***** * *** * * ***************** *** *
*   *     * * *   *   *   *   *   * *         *         *   *
* *** ***** * ********* ******* *** ********* * ********* * *
*   *     *   *             *   * * *   *   * * * *   *   * *
*** ***** ***************** * *** * * * *** * * * * * * * ***
* *   * *     *         *   * * *   * *     * * *   *   *   *
* *** * ***** * ******* * * * * * *** *** *** * ******* *** *
*   * *         *         * * *   *     * *   *       *   * *
* *** ********************* * * ******* *** ********* ***** *
* *   *           *     *   * *       * *   *   *     *   * *
* * *** ********* * *** ***** ******* * * *** * * ***** * * *
* *     *       * *   *   *   *   *   * *     *   *     *   *
* ************* * * * *** * ***** * *** *************** *** *
*   *           * * * * * *   *   *   *         *       * * *
* *** * ********* *** * * *** * ***** ***** *** *** ***** * *
*     *               *       *             *       *       *
*************************************************************
