*********
*   *   *
*** * ***
* * *   *
* * *** *
*       *
*********
