*********************************************************************************
*.*      . . .*  . .*. .* *             *    . .*    . .*    . . . . .*    . .* *
* ******* *** * * * * * * * ********* *** *** * * *** * *** * ******* ***** * * *
*. . .*. .*. .* *.*. .*.*           *       *.*.* *. .*. .* *.*   *. .*. . .*.* *
***** * *** ***** ***** *** ***************** * *** ***** *** *** * *** ***** * *
*   *. .* *.*. .*.*   *. .* *. . . . . .*. . .*. . .*   *. .*.*   *. .*. .* *.* *
* ******* * * * * * * *** *** ********* * *********** ***** * * * *** *** * * * *
*   *     *. .*. .* *   *. .*. .*   *. .*.*. .*           *. .* *   *. . .* *.* *
* * * * * ********* ******* * * * *** *** * * ******* *** ***** *** ******* * * *
* *   * *   *. .  *. . . . .* *.* *. .*  . .*.*. . .* * *     *. .*   * *. .*. .*
* ***** *** * * *** *********** * * ***** *** * *** * * *** *** * *** * * * *** *
*     * *   *.*. . .*      . . .*  . . .*   *. .  *.*   * *   *.*. .*   *.*. .*.*
******* * *** ******* ***** *********** ********* * *** * *** * *** ***** *** * *
*       *   *.*           *. . . .*   *. .*. .*   *.*   * *   *.* *. . .*.* *. .*
* ***** ***** * ***************** * * *** * * *** * *** * * *** * ***** * * *****
* *     *. .*.*     *. . . .*. . .* *   *.*.*. .* *. .*   *. . .*  . .*.*. . .* *
* * ***** * * ***** * ***** * ***** *** * * *** ***** ***** ***** * * * ***** * *
* *   *. .*. .*     *.*   *. .* *   * * *. .* *. . .*. . .*.*     *.*.*. . .*.* *
* *** * ************* * * ***** * * * * ***** ***** ***** * ******* * ***** * * *
* *   *. .*  . . . . .* *   *     * *   *       *. .*. . .*. . . . .*.*. .*. .* *
* ******* * * *********** * ******* *** *** *** * *** *************** * * ***** *
*. . . . .* *.*   *       *       *   *     *   *. . .*   *         *. .*. .*   *
* *********** * * * * *********** *** ******* ********* *** *** *********** *** *
*.*    . . . .* *   * *       * *   *     *   *       * *   * *     *     *. .* *
* *** * ******* ***** * ***** * *** ***** * *** * *** * * *** ***** * * * *** * *
*. .* *. .*   *     *   *   * *           *   * * *     *   *     * * * *   *. .*
*** * *** * ******* ***** * * ***** *********** * ********* ***** * * * *** *** *
*. .* *. .*       * *     * *     * *           *   *       *   * *   *   *   *.*
* *** * *** *** *** * *********** *** ************* * ******* * * ******* ***** *
*.* * *.*   *   *   *       *   * *   *       *     *   *     * *       *   *. .*
* * * * ***** *** ***** *** * * * * ***** *** * *** *** ***** * *** *** *** * ***
*.*   *. . .*     *   *   *   * *   *     *   * * *   *   *   *   * *   *   *.* *
* * ******* * ***** * * ******* ***** * *** *** * *** *** * ***** * ***** * * * *
*.*       *.*       * * *     *     * * *     * * *   * *   * *   *   *   * *.* *
* ******* * *** ***** *** *** ***** * * ******* * * *** ***** * ***** * *** * * *
*. .*   * *.*   *. .*   * * *     *   * *       *   *     * *   *     * *   *. .*
*** * *** * ***** * *** * * ***** ***** * ******* *** * * * * ***** * * * ***** *
* *.*     *.*. . .*.* * * *             *   *   *   * * *   * *     * * *     *.*
* * * ***** * ***** * * * * *********** *** * ***** * * ***** * ***** * ***** * *
* *.* *. . .*. .* *.*     * *   *     *   * *       * * *   * *   *   *   * * *.*
* * * * * ***** * * ******* * * * *** * *** * ********* * * * *** * ***** * * * *
*. .* *.* *. .*.* *. . .*   * *   *   * *   *   *       * * *     *     * * * *.*
* *** * *** * * * ***** * *** ******* *** ***** *** ***** * ******* ***** * * * *
*. .* *. . .*. .  *. . .*   *   *   *     *   *     *     *       * *   * *   *.*
*** ******* ******* ***** ***** * * ******* *** ***** ******* *** * * * * ***** *
* *. . . .*   *. . .*   * *     * *   *   *     *     * *     *   * * * *     *.*
* ******* ***** ***** * * * *** * *** * *** ***** ***** * ********* * * ***** * *
* *     *. . . .* *   *   * *   *   * *       *   *     *           * *     * *.*
* * * *********** * ******* *** *** * *** ***** ***** * ************* ***** * * *
* * *         *     *     *   *   * *   *   *   *     *   *     *     *       *.*
* * *** ***** ******* *** *** *** * *** ***** *** * ***** * *** * ***** ******* *
* *   *   *   *       *       *   * * *     *   * *     * * *   * *   * * *. .*.*
* *** *** * *** ***** ********* *** * ***** *** ******* * * ***** * *** * * * * *
*     * * *     *   * *   *   * *   *     *   *     *   *   *     * *     *.*.*.*
* ***** * ******* * * * * * * * * *** ******* ***** * ******* ***** * ***** * * *
*       *       * * * * *   * * * *         * *   * *       *   *     *. . .*. .*
******* ******* * * *** ***** * * ******* * * * * * ******* *** *** *** *********
*     *     * *   *   *   * * * *         * *   * * *     *   *   *   *. .*  . .*
* *** ***** * ******* *** * * ************* ***** * * *** * * *** ******* *** * *
*   *               *       *                   *     *     *   *        . . .*.*
*********************************************************************************
