*********************
*.*         *       *
* * ******* * *** * *
*.*     *   * *   * *
* *** * * *** * *** *
*. .* * * *   * *   *
*** *** *** *** * ***
* *.*   *   *   *   *
* * * *** *** *******
*. .*     * * *     *
* ***** *** * * *** *
*. . .*     *     * *
***** ***** ******* *
*   *. . .* *. . . .*
* * ***** * * ***** *
* * *. . .* *.*. .*.*
* *** ******* * * * *
*. . .*    . .*.*. .*
* ********* *** *****
*. . . . . .*  . . .*
*********************
