*********************************************************************************
* *           *     *   * *             *       *       *             *       * *
* ******* *** * * * * * * * ********* *** *** * * *** * *** * ******* ***** * * *
*     *   *   * * *   * *           *       * * * *   *   * * *   *   *     * * *
***** * *** ***** ***** *** ***************** * *** ***** *** *** * *** ***** * *
*   *   * * *   * *   *   * *           *     *     *   *   * *   *   *   * * * *
* ******* * * * * * * *** *** ********* * *********** ***** * * * *** *** * * * *
*   *     *   *   * *   *   *   *   *   * *   *           *   * *   *     * * * *
* * * * * ********* ******* * * * *** *** * * ******* *** ***** *** ******* * * *
* *   * *   *     *         * * * *   *     * *     * * *     *   *   * *   *   *
* ***** *** * * *** *********** * * ***** *** * *** * * *** *** * *** * * * *** *
*     * *   * *     *           *       *   *     * *   * *   * *   *   * *   * *
******* * *** ******* ***** *********** ********* * *** * *** * *** ***** *** * *
*       *   * *           *       *   *   *   *   * *   * *   * * *     * * *   *
* ***** ***** * ***************** * * *** * * *** * *** * * *** * ***** * * *****
* *     *   * *     *       *     * *   * * *   * *   *   *     *     * *     * *
* * ***** * * ***** * ***** * ***** *** * * *** ***** ***** ***** * * * ***** * *
* *   *   *   *     * *   *   * *   * * *   * *     *     * *     * * *     * * *
* *** * ************* * * ***** * * * * ***** ***** ***** * ******* * ***** * * *
* *   *   *           * *   *     * *   *       *   *     *         * *   *   * *
* ******* * * *********** * ******* *** *** *** * *** *************** * * ***** *
*         * * *   *       *       *   *     *   *     *   *         *   *   *   *
* *********** * * * * *********** *** ******* ********* *** *** *********** *** *
* *           * *   * *       * *   *     *   *       * *   * *     *     *   * *
* *** * ******* ***** * ***** * *** ***** * *** * *** * * *** ***** * * * *** * *
*   * *   *   *     *   *   * *           *   * * *     *   *     * * * *   *   *
*** * *** * ******* ***** * * ***** *********** * ********* ***** * * * *** *** *
*   * *   *       * *     * *     * *           *   *       *   * *   *   *   * *
* *** * *** *** *** * *********** *** ************* * ******* * * ******* ***** *
* * * * *   *   *   *       *   * *   *       *     *   *     * *       *   *   *
* * * * ***** *** ***** *** * * * * ***** *** * *** *** ***** * *** *** *** * ***
* *   *     *     *   *   *   * *   *     *   * * *   *   *   *   * *   *   * * *
* * ******* * ***** * * ******* ***** * *** *** * *** *** * ***** * ***** * * * *
* *       * *       * * *     *     * * *     * * *   * *   * *   *   *   * * * *
* ******* * *** ***** *** *** ***** * * ******* * * *** ***** * ***** * *** * * *
*   *   * * *   *   *   * * *     *   * *       *   *     * *   *     * *   *   *
*** * *** * ***** * *** * * ***** ***** * ******* *** * * * * ***** * * * ***** *
* * *     * *     * * * * *             *   *   *   * * *   * *     * * *     * *
* * * ***** * ***** * * * * *********** *** * ***** * * ***** * ***** * ***** * *
* * * *     *   * * *     * *   *     *   * *       * * *   * *   *   *   * * * *
* * * * * ***** * * ******* * * * *** * *** * ********* * * * *** * ***** * * * *
*   * * * *   * * *     *   * *   *   * *   *   *       * * *     *     * * * * *
* *** * *** * * * ***** * *** ******* *** ***** *** ***** * ******* ***** * * * *
*   * *     *     *     *   *   *   *     *   *     *     *       * *   * *   * *
*** ******* ******* ***** ***** * * ******* *** ***** ******* *** * * * * ***** *
* *       *   *     *   * *     * *   *   *     *     * *     *   * * * *     * *
* ******* ***** ***** * * * *** * *** * *** ***** ***** * ********* * * ***** * *
* *     *       * *   *   * *   *   * *       *   *     *           * *     * * *
* * * *********** * ******* *** *** * *** ***** ***** * ************* ***** * * *
* * *         *     *     *   *   * *   *   *   *     *   *     *     *       * *
* * *** ***** ******* *** *** *** * *** ***** *** * ***** * *** * ***** ******* *
* *   *   *   *       *       *   * * *     *   * *     * * *   * *   * * *   * *
* *** *** * *** ***** ********* *** * ***** *** ******* * * ***** * *** * * * * *
*     * * *     *   * *   *   * *   *     *   *     *   *   *     * *     * * * *
* ***** * ******* * * * * * * * * *** ******* ***** * ******* ***** * ***** * * *
*       *       * * * * *   * * * *         * *   * *       *   *     *     *   *
******* ******* * * *** ***** * * ******* * * * * * ******* *** *** *** *********
*     *     * *   *   *   * * * *         * *   * * *     *   *   *   *   *     *
* *** ***** * ******* *** * * ************* ***** * * *** * * *** ******* *** * *
*   *               *       *                   *     *     *   *             * *
*********************************************************************************
