*************************************************************
*. . . .*     *   *     *           *     *   *       *     *
******* * * * * *** * *** *** ***** * * * * *** * *** * * * *
*   *. .* * *   *   *     * *     * * * * *     *   * * * * *
* * * *** * *** * ********* ***** * *** * ********* * *** * *
* * *.*   *   * * *         *     *   * * *         *     * *
* *** ***** * * * *** *** *** ******* * * * *************** *
*   *. . .* * * *   * *   *   *     *   * * * *     *       *
* * ***** * * * *** *** * * *** ********* * * * * *** *******
* *   * *.* * *   *     * *   *   *     * * *   * *   *     *
*** * * * *** *********** *** *** * *** * * * *** * ******* *
*   *   *. .* *     *   *   *   * *   *   * * * *   *       *
* ***** *** * * * * * ***** *** * *** ***** * * ***** *******
* *. .*   *.*   * * * *   *   * *   *       * *             *
* * * ***** * *** * * * * * *** *** ********* * *********** *
* *.*. . . .* *   *   * *   *   *     *   *   * *           *
* * ********* * ******* ***** *** ***** * * ***** ********* *
* *. . . .* * *       * *     *   *     * *   *   *   *     *
* ******* * * ******* * * ******* * ***** *** * ***** * *****
* *. .  *.*       *   * *   *     * *   *   *   *     *     *
* * * * * ***** *** * * *** * *** * * ***** ******* * ***** *
* *.*.* *. .*   *   * * * * * *   * *     *         *   *   *
* * * ***** *** * ***** * * * ***** *** *** ********* *** ***
*. .*.*. .*. .* *   *   * * *         * *   *       * *   * *
* *** * * *** ***** * *** * ********* * * *** ***** *** *** *
*.* *. .*. . .*   * * *   * *     *     *   *   * *     *   *
* * *********** * * * * * * * *** ***** *** *** * ******* * *
*. . . . . .*   *   * * * *   * *   *     *   *   *       * *
*********** * ******* *** ***** *** ******* ***** ***** *** *
*       *. .*         *       *   *   *     *   *     * *   *
******* * ******* ***** ***** *** *** * *** * * ***** * * ***
*       *.*. . .*     *   *       *   * * * * *   *   * *   *
* ***** * * *** ***** *** * ******* *** * * * * *** ******* *
* *   * *. .* *.*     *   * *     *   * * * * *     *       *
* * * ******* * ***** * *** * *** *** * * * * ******* ***** *
* * *         *. . .* *   * * * *   * * *   * *     *     * *
* * *** *** ******* * *** *** * *** * * ***** *** * *** * ***
* *   *   * *. . .*.*     *   *   * * *           *   * *   *
* * ***** *** *** * ***** * *** * * * *************** ***** *
*   *     *. .* *. .*   * *   * *     *     *   *         * *
***** *** * *** ******* * *** * ******* *** * * * ******* * *
*     *   *. .*         *   * *   *     * * * *     *   *   *
* ******* *** * ******* *** * *** * ***** * ********* * *****
* *. . .* *. .*     *   *   *   * * * *   *           *     *
* * *** *** *** *** ***** ***** * * * * * ***************** *
*. .* *.*. .* *   *     * *   * * * *   * *. . . .*       * *
* *** * * *** *** ***** * * * * *** ***** * ***** * ***** * *
*. . .*. .* *   * *   *   * * *           *.* *. .* *   *   *
***** ***** * * * * ******* * *********** * * * *** * * *** *
*   *. .* *   * * *         *     *. . .* *.* *.*   * *     *
*** *** * * *** * *** *** ***** *** *** *** * * *** * *******
*     *.*   *   *   *   * *     *. .* *.*. .*. .*   * *     *
* ***** * *** ***** ***** * ***** *** * * *** *** ***** *** *
* *. . .*   *             * *. . .*   *. .* *. .*     * *   *
* * ***** ******************* ***** * ***** *** * *** * * ***
* *.*     *. . . . .*. . .*. .*     * *. . . .*.*   *   *   *
* * * ***** ******* * *** * *** ***** * ***** * *** ******* *
* *.* *. . .* *   *. .* *. .*   * *   *. .* *. .*     *. . .*
* * *** ***** * * ***** ***** *** * ***** * *********** *** *
*  . . .*       *                 *      . . . . . . . .*  .*
*************************************************************
