*************************************************************
*.*     *          . .* *  . . . . .*       *     *         *
* *** * * ********* * * * * ******* *** * * * * * * ******* *
*. .* * *   *. . . .*.*   *.*. .* *. .* * * * * * *   *   * *
*** * * *** * ******* * *** * * * *** * * *** * ***** * *** *
* *.* *   * *.*     *.* * *. .*.*   *.* *     *       * *   *
* * * * *** * * ***** * * ***** * *** * *************** * * *
* *.* * *   *.*  . . .*   *. .*.*. . .*   *       *     * * *
* * * *** *** *** ********* * * * ******* * ***** * *** * ***
* *.*       *. .*.*  . . . .*. .*. .*. .*   *   * * * * *   *
* * ******* *** * *** ************* * * ***** * * * * * *** *
* *. . . .*   *.*. . .*   *       *. .*.*     *     *   *. .*
* ******* *** * ********* * * ********* * *************** * *
*   *   *. .* *. .*       * *         *.*     *   *. . . .*.*
* *** * *** ***** ***** *** ***** *** * ***** *** * ******* *
*     *   *. . .*. .*   *   *   *   * *. . .*     *.*     *.*
* ***** * ***** * * * * * *** * *** * ***** ******* * ***** *
*     * *     *.* *.* * *   * * *   * *   *. . .*. .*   *. .*
***** * ******* *** * ***** *** * ***** * ***** * *** * * ***
*     *        . . .*           *       *      . .*   *  . .*
*************************************************************
