*********************
* *         *       *
* * ******* * *** * *
* *     *   * *   * *
* *** * * *** * *** *
*   * * * *   * *   *
*** *** *** *** * ***
* * *   *   *   *   *
* * * *** *** *******
*   *     * * *     *
* ***** *** * * *** *
*     *     *     * *
***** ***** ******* *
*   *     * *       *
* * ***** * * ***** *
* * *     * * *   * *
* *** ******* * * * *
*     *       * *   *
* ********* *** *****
*           *       *
*********************
